8 8
0 0 0 0 0 0 0 0
0 0 5 5 5 5 5 0
0 0 1 1 1 1 5 0
0 1 1 1 0 5 5 0
0 1 1 1 0 0 0 0
0 1 2 1 1 1 0 1
1 1 2 1 1 2 1 1
3 2 1 2 1 1 2 1

