8 8
0 0 0 0 0 0 0 0
0 0 0 1 1 0 0 0
0 0 0 1 6 1 0 0
0 0 1 2 6 1 5 0
0 1 1 2 6 1 5 0
0 0 1 6 2 1 5 0
0 0 0 1 1 0 0 0
0 0 0 0 0 0 0 0

